#################
#               #
#    S  ^ v  A  #
#               #
#################
1 d
#################
#       ^       #
#     S      A  #
#         v     #
#################
2 d
#################
#       v       #
#      S     A  #
#         ^     #
#################
3 d
#################
#               #
#       v ^  A  #
#               #
#################
Du wurdest von einem Monster gefressen.
