##########
#        #
#  S  A  #
#        #
##########
1 d
##########
#        #
#   S A  #
#        #
##########
2 d
##########
#        #
#    SA  #
#        #
##########
3 d
##########
#        #
#     A  #
#        #
##########
Gewonnen!
