##########
#        #
#  S  A  #
#        #
##########
1 a
##########
#        #
# S   A  #
#        #
##########
2 a
##########
#        #
#S    A  #
#        #
##########
3 a
##########
#        #
#S    A  #
#        #
##########
4 d
##########
#        #
# S   A  #
#        #
##########
5 d
##########
#        #
#  S  A  #
#        #
##########
6 w
##########
#  S     #
#     A  #
#        #
##########
7 w
##########
#  S     #
#     A  #
#        #
##########
8 s
##########
#        #
#  S  A  #
#        #
##########
9 s
##########
#        #
#     A  #
#  S     #
##########
10 s
##########
#        #
#     A  #
#  S     #
##########
11 s
##########
#        #
#     A  #
#  S     #
##########
12 d
##########
#        #
#     A  #
#   S    #
##########
13 d
##########
#        #
#     A  #
#    S   #
##########
14 d
##########
#        #
#     A  #
#     S  #
##########
15 d
##########
#        #
#     A  #
#      S #
##########
16 d
##########
#        #
#     A  #
#       S#
##########
17 d
##########
#        #
#     A  #
#       S#
##########
18 w
##########
#        #
#     A S#
#        #
##########
19 w
##########
#       S#
#     A  #
#        #
##########
20 d
##########
#       S#
#     A  #
#        #
##########
21 d
##########
#       S#
#     A  #
#        #
##########
22 w
##########
#       S#
#     A  #
#        #
##########
23 w
##########
#       S#
#     A  #
#        #
##########
24 a
##########
#      S #
#     A  #
#        #
##########
25 a
##########
#     S  #
#     A  #
#        #
##########
26 w
##########
#     S  #
#     A  #
#        #
##########
27 w
##########
#     S  #
#     A  #
#        #
##########
28 s
##########
#        #
#     A  #
#        #
##########
Gewonnen!
